    #####       
    #   #       
  ###  $###     
  #  $    #     
### # ##  ######
#   # ##$ #  ..#
# $   $   $  ..#
##### ### #  ..#
    #  @  ######
    #######     
